"filename", "language", "TypeScript", "TypeScript React", "CSS", "comment", "blank", "total"
"d:\Projekty\eobuwie\src\components\atoms\button\Button.module.css", "CSS", 0, 0, 33, 2, 6, 41
"d:\Projekty\eobuwie\src\components\atoms\button\Button.spec.tsx", "TypeScript React", 0, 37, 0, 0, 13, 50
"d:\Projekty\eobuwie\src\components\atoms\button\Button.tsx", "TypeScript React", 0, 19, 0, 5, 3, 27
"d:\Projekty\eobuwie\src\components\atoms\button\types.d.ts", "TypeScript", 8, 0, 0, 0, 2, 10
"d:\Projekty\eobuwie\src\components\atoms\divider\Divider.module.css", "CSS", 0, 0, 7, 0, 0, 7
"d:\Projekty\eobuwie\src\components\atoms\divider\Divider.spec.tsx", "TypeScript React", 0, 18, 0, 0, 9, 27
"d:\Projekty\eobuwie\src\components\atoms\divider\Divider.tsx", "TypeScript React", 0, 7, 0, 3, 4, 14
"d:\Projekty\eobuwie\src\components\atoms\divider\types.d.ts", "TypeScript", 3, 0, 0, 0, 0, 3
"d:\Projekty\eobuwie\src\components\atoms\input\Input.module.css", "CSS", 0, 0, 18, 1, 4, 23
"d:\Projekty\eobuwie\src\components\atoms\input\Input.spec.tsx", "TypeScript React", 0, 26, 0, 0, 11, 37
"d:\Projekty\eobuwie\src\components\atoms\input\Input.tsx", "TypeScript React", 0, 19, 0, 3, 3, 25
"d:\Projekty\eobuwie\src\components\atoms\input\types.d.ts", "TypeScript", 9, 0, 0, 0, 1, 10
"d:\Projekty\eobuwie\src\components\atoms\label\Label.module.css", "CSS", 0, 0, 17, 0, 3, 20
"d:\Projekty\eobuwie\src\components\atoms\label\Label.spec.tsx", "TypeScript React", 0, 35, 0, 0, 10, 45
"d:\Projekty\eobuwie\src\components\atoms\label\Label.tsx", "TypeScript React", 0, 17, 0, 3, 3, 23
"d:\Projekty\eobuwie\src\components\atoms\label\types.d.ts", "TypeScript", 7, 0, 0, 0, 0, 7
"d:\Projekty\eobuwie\src\components\atoms\month_day\MonthDay.module.css", "CSS", 0, 0, 8, 1, 8, 17
"d:\Projekty\eobuwie\src\components\atoms\month_day\MonthDay.spec.tsx", "TypeScript React", 0, 103, 0, 2, 17, 122
"d:\Projekty\eobuwie\src\components\atoms\month_day\MonthDay.tsx", "TypeScript React", 0, 43, 0, 1, 6, 50
"d:\Projekty\eobuwie\src\components\atoms\month_day\types.d.ts", "TypeScript", 12, 0, 0, 0, 0, 12
"d:\Projekty\eobuwie\src\components\atoms\star\Star.module.css", "CSS", 0, 0, 9, 0, 2, 11
"d:\Projekty\eobuwie\src\components\atoms\star\Star.spec.tsx", "TypeScript React", 0, 23, 0, 0, 9, 32
"d:\Projekty\eobuwie\src\components\atoms\star\Star.tsx", "TypeScript React", 0, 18, 0, 3, 4, 25
"d:\Projekty\eobuwie\src\components\atoms\star\types.d.ts", "TypeScript", 5, 0, 0, 0, 0, 5
"d:\Projekty\eobuwie\src\components\molecules\date_picker\DatePicker.module.css", "CSS", 0, 0, 160, 5, 26, 191
"d:\Projekty\eobuwie\src\components\molecules\date_picker\DatePicker.spec.tsx", "TypeScript React", 0, 86, 0, 6, 30, 122
"d:\Projekty\eobuwie\src\components\molecules\date_picker\DatePicker.tsx", "TypeScript React", 0, 42, 0, 5, 10, 57
"d:\Projekty\eobuwie\src\components\molecules\date_picker\DatePickerModal.tsx", "TypeScript React", 0, 122, 0, 14, 10, 146
"d:\Projekty\eobuwie\src\components\molecules\date_picker\types.d.ts", "TypeScript", 16, 0, 0, 0, 1, 17
"d:\Projekty\eobuwie\src\components\molecules\reservation_header\ReservationHeader.module.css", "CSS", 0, 0, 5, 0, 0, 5
"d:\Projekty\eobuwie\src\components\molecules\reservation_header\ReservationHeader.spec.tsx", "TypeScript React", 0, 23, 0, 0, 13, 36
"d:\Projekty\eobuwie\src\components\molecules\reservation_header\ReservationHeader.tsx", "TypeScript React", 0, 15, 0, 3, 3, 21
"d:\Projekty\eobuwie\src\components\molecules\reservation_header\types.d.ts", "TypeScript", 6, 0, 0, 0, 0, 6
"d:\Projekty\eobuwie\src\components\molecules\star_rating\StarRating.module.css", "CSS", 0, 0, 30, 0, 8, 38
"d:\Projekty\eobuwie\src\components\molecules\star_rating\StarRating.spec.tsx", "TypeScript React", 0, 26, 0, 0, 11, 37
"d:\Projekty\eobuwie\src\components\molecules\star_rating\StarRating.tsx", "TypeScript React", 0, 25, 0, 3, 3, 31
"d:\Projekty\eobuwie\src\components\molecules\star_rating\types.d.ts", "TypeScript", 6, 0, 0, 0, 0, 6
"d:\Projekty\eobuwie\src\components\organisms\ReservationCard\ReservationCard.module.css", "CSS", 0, 0, 32, 4, 12, 48
"d:\Projekty\eobuwie\src\components\organisms\ReservationCard\ReservationCard.tsx", "TypeScript React", 0, 77, 0, 5, 8, 90
"d:\Projekty\eobuwie\src\components\organisms\ReservationCard\types.d.ts", "TypeScript", 20, 0, 0, 0, 1, 21
"d:\Projekty\eobuwie\src\components\pages\app\App.module.css", "CSS", 0, 0, 8, 0, 0, 8
"d:\Projekty\eobuwie\src\components\pages\app\App.spec.tsx", "TypeScript React", 0, 4, 0, 1, 3, 8
"d:\Projekty\eobuwie\src\components\pages\app\App.tsx", "TypeScript React", 0, 23, 0, 0, 4, 27
"d:\Projekty\eobuwie\src\hooks\usePickerKeyboardControl.ts", "TypeScript", 95, 0, 0, 32, 22, 149
"d:\Projekty\eobuwie\src\hooks\usePrevious.ts", "TypeScript", 8, 0, 0, 0, 2, 10
"d:\Projekty\eobuwie\src\index.tsx", "TypeScript React", 0, 12, 0, 0, 2, 14
"d:\Projekty\eobuwie\src\react-app-env.d.ts", "TypeScript", 0, 0, 0, 1, 1, 2
"d:\Projekty\eobuwie\src\setupTests.ts", "TypeScript", 1, 0, 0, 4, 1, 6
"d:\Projekty\eobuwie\src\styles\colors.ts", "TypeScript", 17, 0, 0, 1, 1, 19
"d:\Projekty\eobuwie\src\styles\global.css", "CSS", 0, 0, 97, 11, 37, 145
"d:\Projekty\eobuwie\src\utils\computeCalendarDays.spec.ts", "TypeScript", 52, 0, 0, 5, 22, 79
"d:\Projekty\eobuwie\src\utils\computeCalendarDays.ts", "TypeScript", 34, 0, 0, 4, 4, 42
"d:\Projekty\eobuwie\src\utils\crossBrowserElClosest.ts", "TypeScript", 16, 0, 0, 6, 5, 27
"d:\Projekty\eobuwie\src\utils\findFocusableElements.ts", "TypeScript", 4, 0, 0, 0, 0, 4
"d:\Projekty\eobuwie\src\utils\getCalendarMonthBoundries.spec.ts", "TypeScript", 26, 0, 0, 12, 18, 56
"d:\Projekty\eobuwie\src\utils\getCalendarMonthBoundries.ts", "TypeScript", 21, 0, 0, 13, 14, 48
"d:\Projekty\eobuwie\src\utils\joinClassNames.spec.ts", "TypeScript", 7, 0, 0, 0, 3, 10
"d:\Projekty\eobuwie\src\utils\joinClassNames.ts", "TypeScript", 1, 0, 0, 3, 0, 4
"d:\Projekty\eobuwie\src\utils\scoreToStarValue.spec.ts", "TypeScript", 24, 0, 0, 0, 7, 31
"d:\Projekty\eobuwie\src\utils\scoreToStarValue.ts", "TypeScript", 6, 0, 0, 5, 0, 11
"Total", "-", 404, 820, 424, 167, 400, 2215